11111111111111111111
11000111010101010101
10010010000000000001
10101010111111111111
10101010000000000001
10101001111111111101
10101010000000000001
10101010111111111111
10101010000000000001
10101001111111111101
10101010000000000001
10101010111111111111
10101010000000000001
10101001111111111101
10101010000000000001
10101010111111111111
10101010000000000001
10101011111111111101
10001000000000000001
11111111111111111111
