11111111111111111111
10101010000000010101
10000000111111000001
11111111000000011111
10000000011111100001
10111111100000001101
10000000001111110001
11111111110000000101
10000000000111110011
10111111111000001001
10000000000011100101
11111111111100010011
10000000000001001001
10111111111110100101
10000000000010101001
11111111111010101011
10000000000010101001
10111111111110101101
10000000000000100001
11111111111111111111
