11111111111111111111
10101010101010101011
10000020000000000001
11111111111111111101
10000000000000000001
10111111111111111111
10000000000000000001
11111111111111111101
10000000000000000001
10111111111111111111
10000000000000000001
11111111111111111101
10000000000000000001
10111111111111111101
10000000000000000011
11111111111111111001
10000000000000000101
10111111111111111101
10000000000003000001
11111111111111111111
