11111111111111111111
10100101010111111111
10110121000100000001
10110101001111100001
10100101000000000001
10100101001111000001
10100030001000000001
10100000001000000001
10111111111110000001
10000000000000000001
10000000000000000001
10000000000000000001
10000000000000000001
10000000000000000001
10000000000000000001
10000000000000000001
10000000000000000001
10000000000000000001
10000000000000000001
11111111111111111111